completion_tokens,prompt_tokens,total_tokens,elapsed_time,batches,prompt_name
243,1526,1769,00:03.637,1,bucket_472
304,1250,1554,00:03.119,1,bucket_512
109,1240,1349,00:01.497,1,bucket_734
374,1309,1683,00:03.007,1,bucket_6
232,1235,1467,00:03.590,1,bucket_7
301,1226,1527,00:02.591,1,bucket_24
231,1239,1470,00:02.139,1,bucket_367
240,1230,1470,00:01.932,1,bucket_433
133,1178,1311,00:01.897,1,bucket_152
203,1159,1362,00:02.052,1,bucket_387
