completion_tokens,prompt_tokens,total_tokens,elapsed_time,batches,prompt_name
4,135,139,00:01.249,1,index
4,135,139,00:01.386,1,id
41319,55351,96670,04:42.183,24,beer-name
3209,2244,5453,00:21.483,1,style
554,1165,1719,00:03.965,1,ounces
3143,2677,5820,00:20.885,1,abv
1841,2266,4107,00:12.099,1,ibu
9516,11238,20754,01:03.365,6,brewery-id
9629,12997,22626,01:02.602,6,brewery-name
8120,10232,18352,00:52.574,5,city
889,1380,2269,00:05.892,1,state
