completion_tokens,prompt_tokens,total_tokens,elapsed_time,batches,prompt_name
185,1080,1265,00:01.958,1,bucket_336
198,1096,1294,00:02.502,1,bucket_908
245,989,1234,00:02.679,1,bucket_344
149,932,1081,00:01.743,1,bucket_907
234,943,1177,00:02.367,1,bucket_1335
169,807,976,00:01.700,1,bucket_135
179,840,1019,00:01.583,1,bucket_173
155,829,984,00:01.824,1,bucket_341
226,832,1058,00:02.485,1,bucket_497
241,816,1057,00:02.071,1,bucket_1330
