completion_tokens,prompt_tokens,total_tokens,elapsed_time,batches,prompt_name
326,6918,7244,00:03.121,1,bucket_29
409,4925,5334,00:03.395,1,bucket_2
178,3795,3973,00:01.848,1,bucket_0
270,3759,4029,00:02.358,1,bucket_173
333,3790,4123,00:03.107,1,bucket_225
285,3547,3832,00:02.968,1,bucket_23
259,3598,3857,00:02.720,1,bucket_53
207,3635,3842,00:01.988,1,bucket_155
334,3617,3951,00:02.615,1,bucket_230
350,3432,3782,00:02.778,1,bucket_1
