completion_tokens,prompt_tokens,total_tokens,elapsed_time,batches,prompt_name
287,1526,1813,00:02.912,1,bucket_472
228,1250,1478,00:02.317,1,bucket_512
101,1240,1341,00:01.467,1,bucket_734
217,1309,1526,00:02.165,1,bucket_6
274,1235,1509,00:02.366,1,bucket_7
234,1226,1460,00:02.632,1,bucket_24
142,1239,1381,00:01.894,1,bucket_367
197,1230,1427,00:01.959,1,bucket_433
251,1178,1429,00:02.792,1,bucket_152
237,1159,1396,00:03.282,1,bucket_387
