completion_tokens,prompt_tokens,total_tokens,elapsed_time,batches,prompt_name
341,2757,3098,00:03.395,1,bucket_32
189,2045,2234,00:01.924,1,bucket_132
68,1202,1270,00:01.647,1,bucket_205
117,1077,1194,00:01.416,1,bucket_181
43,1134,1177,00:01.521,1,bucket_396
175,1034,1209,00:02.433,1,bucket_424
59,844,903,00:01.621,1,bucket_168
40,841,881,00:00.922,1,bucket_312
270,928,1198,00:02.394,1,bucket_130
224,965,1189,00:02.107,1,bucket_707
