completion_tokens,prompt_tokens,total_tokens,elapsed_time,batches,prompt_name
337,1526,1863,00:02.902,1,bucket_472
153,1250,1403,00:01.934,1,bucket_512
126,1240,1366,00:02.460,1,bucket_734
119,1309,1428,00:01.978,1,bucket_6
236,1235,1471,00:02.328,1,bucket_7
303,1226,1529,00:02.996,1,bucket_24
199,1239,1438,00:02.141,1,bucket_367
294,1230,1524,00:03.159,1,bucket_433
191,1178,1369,00:02.171,1,bucket_152
211,1159,1370,00:02.475,1,bucket_387
