completion_tokens,prompt_tokens,total_tokens,elapsed_time,batches,prompt_name
223,1321,1544,00:02.652,1,bucket_858
249,1388,1637,00:02.283,1,bucket_876
206,1247,1453,00:02.202,1,bucket_3406
337,1303,1640,00:02.927,1,bucket_4267
215,1045,1260,00:02.106,1,bucket_1713
295,1146,1441,00:02.508,1,bucket_1941
203,1123,1326,00:02.298,1,bucket_3780
296,941,1237,00:03.300,1,bucket_195
308,818,1126,00:03.476,1,bucket_457
131,726,857,00:01.807,1,bucket_480
